Subcluster	rachel_subclass	rachel_class	rachel_family
Ast0	Astrocyte	Astrocyte	Non-neuron
Ast1	Astrocyte	Astrocyte	Non-neuron
Ast2	Astrocyte	Astrocyte	Non-neuron
Ast3	Astrocyte	Astrocyte	Non-neuron
End1	Endothelial	Vascular	Non-neuron
End2	Endothelial	Vascular	Non-neuron
Ex0	Glutamatergic	Glutamatergic	Glutamatergic
Ex1	Glutamatergic	Glutamatergic	Glutamatergic
Ex11	Glutamatergic	Glutamatergic	Glutamatergic
Ex12	Glutamatergic	Glutamatergic	Glutamatergic
Ex14	Glutamatergic	Glutamatergic	Glutamatergic
Ex2	Glutamatergic	Glutamatergic	Glutamatergic
Ex3	Glutamatergic	Glutamatergic	Glutamatergic
Ex4	Glutamatergic	Glutamatergic	Glutamatergic
Ex5	Glutamatergic	Glutamatergic	Glutamatergic
Ex6	Glutamatergic	Glutamatergic	Glutamatergic
Ex7	Glutamatergic	Glutamatergic	Glutamatergic
Ex8	Glutamatergic	Glutamatergic	Glutamatergic
Ex9	Glutamatergic	Glutamatergic	Glutamatergic
In0	GABAergic	GABAergic	GABAergic
In1	GABAergic	GABAergic	GABAergic
In10	GABAergic	GABAergic	GABAergic
In11	GABAergic	GABAergic	GABAergic
In2	GABAergic	GABAergic	GABAergic
In3	GABAergic	GABAergic	GABAergic
In4	GABAergic	GABAergic	GABAergic
In5	GABAergic	GABAergic	GABAergic
In6	GABAergic	GABAergic	GABAergic
In7	GABAergic	GABAergic	GABAergic
In8	GABAergic	GABAergic	GABAergic
In9	GABAergic	GABAergic	GABAergic
Mic0	Microglia	Microglia	Non-neuron
Mic1	Microglia	Microglia	Non-neuron
Mic2	Microglia	Microglia	Non-neuron
Mic3	Microglia	Microglia	Non-neuron
Oli0	Oligodendrocyte	Oligodendrocyte lineage	Non-neuron
Oli1	Oligodendrocyte	Oligodendrocyte lineage	Non-neuron
Oli3	Oligodendrocyte	Oligodendrocyte lineage	Non-neuron
Oli4	Oligodendrocyte	Oligodendrocyte lineage	Non-neuron
Oli5	Oligodendrocyte	Oligodendrocyte lineage	Non-neuron
Opc0	OPC	Oligodendrocyte lineage	Non-neuron
Opc1	OPC	Oligodendrocyte lineage	Non-neuron
Opc2	OPC	Oligodendrocyte lineage	Non-neuron
Per	Pericyte	Vascular	Non-neuron